0000000000000000000000000000000000000000
0000000000000000000000000000000000000000
0000000000000000000000000000000000000000
0000000000000000000000000000000000000000
0000000000000000000000000000000000000000
0000000000000000000000000000000000000000
0000000000000000000000000000000000000000
0000000500000000000000000000000000000000
0000005550000000000000005000000000000000
0000000300000000000000055500000000000000
0000000400000000000000004000000222000050
0000000300000000050000003000000000000555
0000000400000000555000004002220000000040
0000000302220000030000003000000022200030
0000000400000000040000004000000000000040
2220000300000222030000003000022200000030
0000000400000000040022204000000000022040
0000220300222000030000003000000002211230
0002112200000000040222004000000021111122
0002111120000000030000003000000211111111
2221111112222222222222222222221111111111
1111111111111111111111111111111111111111
1111111111111111111111111111111111111111
1111111111111111111111111111111111111111
1111111111111111111111111111111111111111