
0000000000000000000000000000000000000000
0000000000000000000000000000000000000000
0000000000000000000000000000000000000000
0000000000000000000000000000000000000000
0000500000500000000000000000050000050000
0005550005550000000000000000555000555000
0000400000400000000000000000040000040000
0000300000300000000000000000030000030000
0000400000400000000000000000040000040000
0000300000300000002222000000030000030000
2222222222222220021111200222222222222222
1111111111111112000000002111111111111111
1111111111111111200000021111111111111111
0000000000000000000000000000000000000000
0000000000000000002222000000000000000000
0000266666666666201111026666666666620000
0002100000000000001111000000000000012000
0021100000000000001111000000000000011200
2000000000000000001111000000000000000002
1200000000000000001111000000000000000021
1126666666666666201111026666666666666211
0010000000000000101111010000000000000100
0010000000000000101111010000000000000100
0010000000000000101111010000000000000100
0010000000000000101111010000000000000100