0000000000000000000000000000000000000000
0000000000000000000000000000000000000000
0000000000000000000000000000000000000000
0000000000000000000000000000000000000000
0000000000000000000000000000000000000000
0000000000000000000000000000000000000000
0000000000000000000000000000000000222222
0000000000000000000000000022222222111111
0000000026662000000000222211111111111100
2200000000000002222222111111111111111000
1122222000000021111111111111111000000000
1111111220000000001111110000000000000022
1111111112220000000000000000000000022211
1111111111112222000000000026662002211111
0001111111111111222220000000000002111110
0000000001111111111112222000000000000000
0000000000000011111111111220000000000000
0000000000000000000111111112666200000000
0000266620000000000001111100000000222222
0000000000000000000000000000000002111111
2222200000000000000000000000002221111111
1111122220000000000000000002221111111110
1111111112220000266620002221111111111100
1111111111112220000000221111111111110000
1111111111111112000002111111111000000000